############
#P* #   X ##
#   # #   ##
## ## #  X #
# X    #   #
#   #  # * #
## ## X#   #
# *    #   #
############
