##########
#P       #
#        #
#   *    #
#  ###   #
#   X    #
#  ### * #
#        #
#    X   #
##########